//MAP CONVERTED BY dmm2tgm.py THIS HEADER COMMENT PREVENTS RECONVERSION, DO NOT REMOVE
"a" = (
/turf/closed/wall,
/area/station/hallway/primary/central)
"j" = (
/obj/effect/turf_decal/loading_area/white{
	dir = 8
	},
/obj/machinery/door/window{
	dir = 4
	},
/obj/structure/window/reinforced{
	dir = 1
	},
/obj/machinery/autobank/wallmount/directional/west,
/turf/open/floor/iron/dark/smooth_large,
/area/station/hallway/primary/central)
"q" = (
/obj/machinery/door/airlock/mining/glass{
	name = "Banking Terminals"
	},
/turf/open/floor/iron/dark/small,
/area/station/hallway/primary/central)
"r" = (
/obj/effect/turf_decal/tile/blue/half/contrasted{
	dir = 8
	},
/turf/open/floor/iron,
/area/station/hallway/primary/central)
"t" = (
/obj/effect/spawner/structure/window/reinforced,
/turf/open/floor/plating,
/area/station/hallway/primary/central)
"v" = (
/turf/open/floor/iron/dark/small,
/area/station/hallway/primary/central)
"y" = (
/obj/machinery/light/cold/directional/east,
/turf/open/floor/iron/dark/small,
/area/station/hallway/primary/central)
"z" = (
/turf/closed/wall/r_wall,
/area/station/ai_monitored/command/storage/eva)
"H" = (
/obj/machinery/camera/autoname/directional/west,
/turf/open/floor/iron/dark/small,
/area/station/hallway/primary/central)
"I" = (
/obj/effect/turf_decal/tile/blue/anticorner/contrasted{
	dir = 1
	},
/turf/open/floor/iron,
/area/station/hallway/primary/central)
"J" = (
/obj/effect/turf_decal/loading_area/white{
	dir = 8
	},
/obj/machinery/door/window{
	dir = 4
	},
/obj/structure/window/reinforced,
/obj/machinery/autobank/wallmount/directional/west,
/turf/open/floor/iron/dark/smooth_large,
/area/station/hallway/primary/central)

(1,1,1) = {"
z
z
z
z
z
"}
(2,1,1) = {"
z
J
H
j
a
"}
(3,1,1) = {"
z
v
y
v
t
"}
(4,1,1) = {"
z
v
a
t
a
"}
(5,1,1) = {"
z
v
q
I
r
"}
