//MAP CONVERTED BY dmm2tgm.py THIS HEADER COMMENT PREVENTS RECONVERSION, DO NOT REMOVE
"a" = (
/obj/effect/turf_decal/siding/thinplating/dark{
	dir = 4
	},
/obj/machinery/light/cold/directional/east,
/turf/open/floor/iron/dark/small,
/area/station/hallway/secondary/exit)
"v" = (
/obj/effect/turf_decal/siding/thinplating/dark{
	dir = 5
	},
/obj/machinery/autobank/wallmount/directional/east,
/obj/structure/window/reinforced,
/obj/machinery/door/window{
	dir = 8
	},
/obj/effect/turf_decal/loading_area/white{
	dir = 4
	},
/turf/open/floor/iron/dark/smooth_large,
/area/station/hallway/secondary/exit)
"x" = (
/obj/effect/turf_decal/siding/thinplating/dark{
	dir = 6
	},
/obj/machinery/autobank/wallmount/directional/east,
/obj/structure/window/reinforced{
	dir = 1
	},
/obj/machinery/door/window{
	dir = 8
	},
/obj/effect/turf_decal/loading_area/white{
	dir = 4
	},
/turf/open/floor/iron/dark/smooth_large,
/area/station/hallway/secondary/exit)
"G" = (
/turf/closed/wall,
/area/station/hallway/secondary/exit)

(1,1,1) = {"
v
a
x
"}
(2,1,1) = {"
G
G
G
"}
