//MAP CONVERTED BY dmm2tgm.py THIS HEADER COMMENT PREVENTS RECONVERSION, DO NOT REMOVE
"a" = (
/obj/structure/cable,
/turf/open/floor/iron/dark/small,
/area/station/cargo/lobby)
"b" = (
/obj/machinery/door/airlock/mining/glass{
	name = "Banking Terminals"
	},
/obj/structure/cable,
/turf/open/floor/catwalk_floor/iron_dark,
/area/station/cargo/lobby)
"l" = (
/turf/closed/wall,
/area/station/hallway/primary/central/fore)
"x" = (
/turf/closed/wall,
/area/station/cargo/lobby)
"y" = (
/obj/machinery/autobank/wallmount/directional/north,
/obj/effect/turf_decal/loading_area/white{
	dir = 1
	},
/obj/structure/window/reinforced/spawner/directional/east,
/obj/machinery/door/window/left/directional/south,
/turf/open/floor/iron/dark/smooth_large,
/area/station/cargo/lobby)
"E" = (
/obj/machinery/autobank/wallmount/directional/north,
/obj/effect/turf_decal/loading_area/white{
	dir = 1
	},
/obj/structure/window/reinforced/spawner/directional/west,
/obj/machinery/door/window/right/directional/south,
/turf/open/floor/iron/dark/smooth_large,
/area/station/cargo/lobby)
"K" = (
/obj/structure/cable,
/obj/machinery/power/apc/auto_name/directional/west,
/turf/open/floor/iron/dark/small,
/area/station/cargo/lobby)
"R" = (
/obj/machinery/light/cold/directional/north,
/turf/open/floor/iron/dark/small,
/area/station/cargo/lobby)
"X" = (
/obj/effect/spawner/structure/window,
/turf/open/floor/plating,
/area/station/cargo/lobby)
"Y" = (
/obj/effect/landmark/start/cargo_technician,
/obj/machinery/camera/autoname/directional/east,
/turf/open/floor/iron/dark/small,
/area/station/cargo/lobby)

(1,1,1) = {"
x
x
x
x
"}
(2,1,1) = {"
x
y
K
X
"}
(3,1,1) = {"
x
R
a
b
"}
(4,1,1) = {"
x
E
Y
x
"}
(5,1,1) = {"
l
l
l
l
"}
