//MAP CONVERTED BY dmm2tgm.py THIS HEADER COMMENT PREVENTS RECONVERSION, DO NOT REMOVE
"a" = (
/turf/closed/wall,
/area/station/maintenance/department/cargo)
"e" = (
/obj/structure/cable,
/obj/machinery/atmospherics/pipe/smart/manifold4w/supply/hidden/layer4,
/obj/effect/turf_decal/loading_area/white{
	dir = 8
	},
/obj/machinery/autobank/wallmount/directional/west,
/obj/structure/window/reinforced/spawner/directional/north,
/obj/machinery/door/window/right/directional/east,
/turf/open/floor/iron/dark/smooth_large,
/area/station/maintenance/department/cargo)
"g" = (
/obj/effect/turf_decal/tile/neutral{
	dir = 1
	},
/obj/machinery/door/firedoor,
/obj/machinery/atmospherics/pipe/smart/manifold4w/supply/hidden/layer4,
/obj/machinery/atmospherics/pipe/smart/manifold4w/scrubbers/hidden/layer2,
/turf/open/floor/iron,
/area/station/hallway/primary/central)
"m" = (
/obj/effect/turf_decal/tile/neutral{
	dir = 1
	},
/obj/machinery/atmospherics/pipe/smart/manifold4w/scrubbers/hidden/layer2,
/obj/machinery/atmospherics/pipe/smart/manifold4w/supply/hidden/layer4,
/obj/machinery/status_display/ai/directional/west,
/turf/open/floor/iron,
/area/station/hallway/primary/central)
"q" = (
/obj/structure/cable,
/obj/effect/turf_decal/tile/neutral{
	dir = 1
	},
/obj/machinery/atmospherics/pipe/smart/manifold4w/supply/hidden/layer4,
/obj/machinery/atmospherics/pipe/smart/manifold4w/scrubbers/hidden/layer2,
/turf/open/floor/iron,
/area/station/hallway/primary/central)
"z" = (
/obj/effect/turf_decal/tile/neutral{
	dir = 1
	},
/obj/machinery/atmospherics/pipe/smart/manifold4w/scrubbers/hidden/layer2,
/obj/machinery/atmospherics/pipe/smart/manifold4w/supply/hidden/layer4,
/turf/open/floor/iron,
/area/station/hallway/primary/central)
"B" = (
/turf/open/floor/iron/dark/small,
/area/station/maintenance/department/cargo)
"C" = (
/obj/structure/cable,
/obj/machinery/atmospherics/pipe/smart/manifold4w/supply/hidden/layer4,
/turf/open/floor/iron/dark/small,
/area/station/maintenance/department/cargo)
"P" = (
/obj/structure/cable,
/obj/machinery/atmospherics/pipe/smart/manifold4w/supply/hidden/layer4,
/obj/machinery/door/airlock/maintenance_hatch,
/obj/effect/mapping_helpers/airlock/access/any/supply/maintenance,
/obj/effect/mapping_helpers/airlock/unres{
	dir = 1
	},
/turf/open/floor/plating,
/area/station/maintenance/department/cargo)

(1,1,1) = {"
P
C
e
a
"}
(2,1,1) = {"
a
B
C
a
"}
(3,1,1) = {"
m
z
q
g
"}
