//MAP CONVERTED BY dmm2tgm.py THIS HEADER COMMENT PREVENTS RECONVERSION, DO NOT REMOVE
"a" = (
/obj/effect/turf_decal/siding/thinplating_new/dark{
	dir = 10
	},
/obj/structure/window/reinforced,
/obj/structure/window/reinforced{
	dir = 1
	},
/obj/machinery/door/window{
	dir = 4
	},
/obj/machinery/autobank/wallmount/directional/west,
/obj/effect/turf_decal/loading_area/white{
	dir = 8
	},
/turf/open/floor/iron/dark/smooth_large,
/area/station/commons/dorms)
"d" = (
/obj/effect/turf_decal/siding/thinplating_new/dark{
	dir = 8
	},
/turf/open/floor/iron/dark/smooth_large,
/area/station/commons/dorms)
"s" = (
/obj/effect/turf_decal/siding/thinplating_new/dark{
	dir = 9
	},
/obj/structure/window/reinforced,
/obj/structure/window/reinforced{
	dir = 1
	},
/obj/machinery/door/window{
	dir = 4
	},
/obj/machinery/autobank/wallmount/directional/west,
/obj/effect/turf_decal/loading_area/white{
	dir = 8
	},
/turf/open/floor/iron/dark/smooth_large,
/area/station/commons/dorms)
"M" = (
/turf/open/floor/iron/dark/herringbone,
/area/station/commons/dorms)

(1,1,1) = {"
s
d
a
"}
(2,1,1) = {"
M
M
M
"}
